Тематичнi скоpочення у галузi зв'язку

 Антени
 Методика виконання вимiрювань радiотехнiчних i електродинамiчних параметрiв
 ГСТУ 45.003-97

АС — антена слабко спрямована
АГ — антена гостроспрямована
ДС — дiаграма спрямованостi
КП — коефiцiєнт пiдсилювання
КСД — коефiцiєнт спрямованої дiї
РБП — рiвень бiчних пелюсток
КЗД — коефiцiєнт захисної дiї
МВВ — методика виконання вимiрювань 


 Будiвництво лiнiйних споруд волоконно-оптичних лiнiй зв'язку
 КНД-45-141-99
 
БМ — багатомодове волокно
ВЛ — високовольтна лiнiя
ВОЛЗ — волоконно-оптична лiнiя зв'язку
ВОСП — волоконно-оптична система передачi
ВОП — вимiрювач оптичної потужностi
ДЖ — дистанцiйне живлення
ЕРС — електрорушiйна сила
КВП — контрольно-вимiрювальний пункт
КНД — керiвний нормативний документ
ЛАЦ — лiнiйно-апаратний цех
ЛВМОК — лабораторiя вимiрювання i монтажу оптичного кабелю
ЛЕП — лiнiя електропередачi
ЛЗ — лiнiя зв'язку
ЛПК — липкий полiiзобутиленовий компаунд
ЛС — лiнiйна споруда
МО — модуль оптичний
МТМ — мiська телефонна мережа
НР — нормальнi
НРП — регенерацiйний пункт, що не обслуговується
ОВ — оптичне волокно
ОМ — одномодове волокно
ОК — оптичний кабель
ОРП — регенерацiйний пункт, що обслуговується
ПЛ — полегшенi
ПС — посиленi
ПВТ — полiетилен високого тиску
ПВХ — полiвiнiлхлорид
ПЕ — полiетилен
ПЛ — повiтряна лiнiя
ПЛЗ — повiтряна лiнiя зв'язку
ПНТ — полiетилен низького тиску
РВО — розгалуджувач волоконно-оптичний
СД — свiтлодiод
СП — система передавання
УКХ — ультракороткi хвилi
ЦСЕ — центральний силовий елемент
ШCЗ — шнур свiтловодний з'єднувальний 


 Первинна мережа ЄНСЗ України
 Правила технiчної експлуатацiї. ДКЗIУ. Київ.2001. Частина перша.
 КНД-45-140-99
 
АПК — амплiтудний перемiнний коректор
АСК — автоматизована система корекцiї
АСОТО — автоматизована система оперативно-технiчного обслуговування
АСОТУ — автоматизована система оперативно-технiчного управлiння
АСП — аналогова система передавання
АСТЕ — автоматизована система технiчної експлуатацiї
АСУ — автоматизована система управлiння
АЧХ — амплiтудно-частотна характеристика
БОМС — базова органiзацiя метрологiчної служби
ВСЗ — внутрiшньовиробничий службовий зв'язок
ВЗМП — внутрiшньозонова первинна мережа
ВЗМС — внутрiшньозонова мережна станцiя
ВК-n — вiртуальний контейнер -n рангу
ВМТ — вторинний мережний тракт
ВРС — вузлова радiорелейна станцiя
ВЦТ — вторинний цифровий тракт
ГКС — головна керiвна станцiя
ГКЧ — групова контрольна частота
ГОМС — головна органiзацiя метрологiчної служби
ГОЗ — графiк обходiв i замiн
ГЧП — груповий час проходження
ДКМХ — декаметровi хвилi
ДКС — допомiжна керiвна станцiя
ДКНОП — Державний комiтет по нагляду за охороною працi
ДПМ — дирекцiя первинної мережi
ЕЗЗК — електрозв'язок загального користування
ЄНСЗ — Єдина нацiональна система зв'язку
ЗВТ — засоби вимiрювальної технiки
ЗГ — задавальний генератор
ЗIП — запаснi iнструменти i приладдя
КВ — комплект видiлення
КВг — комплект вiдгалуження
КнП — кiнцевий пункт
КО — контрольований об'єкт
КРС — кiнцева радiорелейна станцiя
КСВ — комплект спряження видiлення
КСВг — комплект спряження вiдгалуження
КСЧ — квантовий стандарт частоти
ЛП — лiнiя передавання
ЛТ — лiнiйний тракт
МВ — мережний вузол
МВВ — мережний вузол видiлення
МВП — мережний вузол перемикання
МЗ — метрологiчне забезпечення
МiПМ — мiська первинна мережа
ММП — магiстральна первинна мережа
ММС — магiстральна мережна станцiя
МПМ — мiсцева первинна мережа
МС — мережна станцiя
МСЕ-Т — мiжнародний союз електрозв'язку-сектор телекомунiкацiй
МСл — метрологiчна служба
МТ — мережний тракт
НД — нормативний документ
НОПП — напiвобслуговуваний пiдсилювальний пункт
НПП — необслуговуваний пiдсилювальний пункт
НРП — необслуговуваний регенерацiйний пункт
ОЕК — об'єкт експлуатацiйного контролю
ОПП — обслуговуваний пiдсилювальний пункт
ОРП — обслуговуваний регенерацiйний пункт
ОЦК — основний цифровий канал
ПК — пристрiй контролю
ПКК — пристрiй керування коректором
ПМТ — первинний мережний тракт
ПСП — промiжна стойка переключення
ПФС — пристрiй формування сигналiв
ПЦI — плезiохронна цифрова iєрархiя
ПЦТ — первинний цифровий тракт
РВР — ремонтно-вiдновнювальнi роботи
РКЧ — часовий розподiл каналiв
РНР — ремонтно-настроювальнi роботи
РРЛ — радiорелейна лiнiя
РРС — радiорелейна станцiя
СМ — синхронний мультиплексор
СММ — мiсцева мережна станцiя
СОТО — система оперативно-технiчного обслуговування
СОТУ — система оперативно-технiчного управлiння
СПМ — сiльська первинна мережа
СТЕ — система технiчної експлуатацiї
СТМ-N — синхронний транспортний модуль N-го рiвня
СТО — секцiя технiчного обслуговування
СТО-IП — секцiя технiчного обслуговування-iнформацiйно-виконавчий пункт
СЦI — синхронна цифрова iєрархiя
ТС — транспортна система
ТМВ — територiальний мережний вузол
ТМС — тактова мережна синхронiзацiя
ТМТ — третинний мережний тракт
ТРЛ — тропосферна радiорелейна лiнiя
ТЦТ — третинний цифровий тракт
ТЧ — тональна частота
УССМ — управлiння стандартизацiї, сертифiкацiї i метрологiї
ЦПМ — центр первинної мережi
ЦСП — цифрова система передавання
ЦУМЗ — центр управлiння мережами зв'язку
ЧМТ — четверинний мережний тракт
ЧЦТ — четверинний цифровий тракт
ЧРК — частотне роздiлення каналiв
ШК — широкосмуговий канал
ШСЗ — штучний супутник зв'язку 


 Первинна мережа ЄНСЗ України
 Правила технiчної експлуатацiї. ДКЗIУ. Київ.2001. Частина третя.
 КНД-45-112-99
 
АВР — аварiйно-вiдновнi роботи. АТЦ — автотранспортний цех
ВП — виробничий пiдроздiл
ВПУ — вузловий пункт управлiння
ВЛ — виробнична лабораторiя
ДIЕ — державна iнспекцiя електрозв'язку
ДЖ — дистанцiйне живлення
ДСЗ — дiльничний службовий зв'язок
ЕРС — електрорушiйна сила
КВП — контрольно-вимiрювальний пункт
КД — кабельна дiльниця
КП — кiнцевий пункт
ЛАЦ — лiнiйно-апаратний цех
ЛТЦ — лiнiйно-технiчний цех
МАВБ — мобiльна аварiйно-вiдновна бригада
НЗП — необслуговуваний захисний пункт
ОК — оптичний кабель
ОРР — охоронно-роз'яснювальна робота
ПВП — переговорний викличний пристрiй
ПКЛЗ — пiдводна кабельна лiнiя зв'язку
ППО — планово-профiлактичне обслуговування
РВБ — ремонтно-вiдновна бригада
СЛIН — старший лiнiйний iнспектор
СТО-IП — секцiя технiчного обслуговування iнформацiйного пункту
Укртелеком — Українське пiдприємство електрозв'язку "Укртелеком"
УКХ — ультракороткi хвилi
ЦЛКС — цех лiнiйно-кабельних споруд
ЦТЕПМ — центр технiчної експлуатацiї первинної мережi 


 Радiорелейний зв'язок.
 ДСТУ 3610-97 та ДСТУ 3936-99

АРРСП — аналогова радiорелейна система (передавання)
АЦРРСП — аналого-цифрова радiорелейна система (передавання)
ВРС — вузлова радiорелейна(радiо) станцiя
ГЕЛ — гiпотетичний еталонний ланцюг ( радiорелейного зв'язку)
ГЕЦТ — гiпотетичний еталонний цифровий тракт( радiорелейного зв'язку)
ДВТВ — данi вищi за смугу вiдеосигналу
ДНТФ[ДВТФ] — данi нижчi[вищi] за смугу тональних частот групового телефонного сигналу
ЗКПБ — залишковий коефiцiєнт помилок за бiтами
КПБ — коефiцiєнт помилок за бiтами
КСУПС — коефiцiєнт сильно уражених помилками секунд
КУПС — коефiцiєнт уражених помилками секунд
КФБП — коефiцiєнт фонових блокiв з помилками
n- KAM — n-позицiйна квадратурна амплiтудна модуляцiя
ПРС — промiжна радiорелейна (радiо) станцiя (ретранслятор)
РРЛТ — радiорелейний тракт
РРСП — радiорелейна система передавання
РРСП ПВ — радiорелейна система передавання прямої видимостi
СУПС — сильно уражена помилками секунда
ТРЛ — тропосферна радiорелейна лiнiя
УПБ — уражений помилками блок
УПС — уражена помилками секунда
ФБП — фоновий блок з помилками
ЦРРСП — цифрова радiорелейна система(передавання)
ЦРРС ПЦI — цифрова радiорелейна система(передавання) для плезiохронної iєрархiї
ЦРРС СЦI — цифрова радiорелейна система(передавання) для синхронної iєрархiї 


 Таксофони з безготiвковими засобами оплати послуг телефонного зв'язку.
 КНД-45-026-96
 
АМТС — автоматична мiжмiська телефонна станцiя
АТС — автоматична телефонна станцiя 
ВТК — вiддiл технiчного контролю
ЕБК — електронна безконтактна картка
ЕК — електронна дебетна картка
ЕКК — електронна контактна картка
ЕРВ — електроннi радiовироби
Ж 1 — жетон для мiжмiського телефонного зв'язку
Ж 2 — жетон для мiського телефонного зв'язку
ПАД — пiдсистема автоматизованого дистанцiйного контролю, дiагностики, тарифiкацiї та збору статистичної iнформацiї
ПЕОМ — персональна електронно-обчислювальна машина
ТО — телефонна одиниця
